...#####
..##.#.####
.###.#.#..#
..#....#..#
#...@.....#
###..###..#
..#..#....#
.##.##