############
#@###.....##
#.###.###.##
#.###.....##
#.....###..#
######..#..#
#..........#
############